###D  ##  ##
# ## ## # ##
# ##      ##
#  # #######
#         ##
######### K#