############ D##
##  #         ##
##    ###   ####
##  ############
##  ##      ####
###        #####
##   ###     ###
##K ############